"filename", "language", "TypeScript", "CSS", "TypeScript JSX", "XML", "comment", "blank", "total"
"c:\GitHub\artdatabanken\src\App.css", "CSS", 0, 3, 0, 0, 0, 1, 4
"c:\GitHub\artdatabanken\src\App.tsx", "TypeScript JSX", 0, 0, 52, 0, 3, 11, 66
"c:\GitHub\artdatabanken\src\assets\logo.svg", "XML", 0, 0, 0, 1, 0, 0, 1
"c:\GitHub\artdatabanken\src\assets\placeholder.svg", "XML", 0, 0, 0, 1, 0, 0, 1
"c:\GitHub\artdatabanken\src\assets\react.svg", "XML", 0, 0, 0, 1, 0, 0, 1
"c:\GitHub\artdatabanken\src\components\Auth.tsx", "TypeScript JSX", 0, 0, 19, 0, 0, 4, 23
"c:\GitHub\artdatabanken\src\components\Footer.module.css", "CSS", 0, 5, 0, 0, 0, 2, 7
"c:\GitHub\artdatabanken\src\components\Footer.tsx", "TypeScript JSX", 0, 0, 10, 0, 0, 2, 12
"c:\GitHub\artdatabanken\src\components\Link.tsx", "TypeScript JSX", 0, 0, 17, 0, 0, 2, 19
"c:\GitHub\artdatabanken\src\components\Navigation.module.css", "CSS", 0, 3, 0, 0, 0, 1, 4
"c:\GitHub\artdatabanken\src\components\Navigation.tsx", "TypeScript JSX", 0, 0, 64, 0, 0, 5, 69
"c:\GitHub\artdatabanken\src\components\Pager.module.css", "CSS", 0, 20, 0, 0, 0, 5, 25
"c:\GitHub\artdatabanken\src\components\Pager.tsx", "TypeScript JSX", 0, 0, 32, 0, 0, 8, 40
"c:\GitHub\artdatabanken\src\components\TableHeader.module.css", "CSS", 0, 8, 0, 0, 0, 2, 10
"c:\GitHub\artdatabanken\src\components\TableHeader.tsx", "TypeScript JSX", 0, 0, 35, 0, 0, 6, 41
"c:\GitHub\artdatabanken\src\components\index.ts", "TypeScript", 7, 0, 0, 0, 0, 2, 9
"c:\GitHub\artdatabanken\src\dialogs\DeleteImageDialog.tsx", "TypeScript JSX", 0, 0, 86, 0, 2, 13, 101
"c:\GitHub\artdatabanken\src\dialogs\Dialog.module.css", "CSS", 0, 8, 0, 0, 0, 2, 10
"c:\GitHub\artdatabanken\src\dialogs\Dialog.tsx", "TypeScript JSX", 0, 0, 52, 0, 3, 11, 66
"c:\GitHub\artdatabanken\src\dialogs\SpeciesDialog.module.css", "CSS", 0, 18, 0, 0, 0, 3, 21
"c:\GitHub\artdatabanken\src\dialogs\SpeciesDialog.tsx", "TypeScript JSX", 0, 0, 169, 0, 3, 23, 195
"c:\GitHub\artdatabanken\src\dialogs\UploadImageDialog\UploadImageDialog.tsx", "TypeScript JSX", 0, 0, 148, 0, 2, 27, 177
"c:\GitHub\artdatabanken\src\dialogs\UploadImageDialog\drawImageOnCanvas.ts", "TypeScript", 30, 0, 0, 0, 0, 5, 35
"c:\GitHub\artdatabanken\src\dialogs\UploadImageDialog\useDebounceEffect.ts", "TypeScript", 11, 0, 0, 0, 1, 3, 15
"c:\GitHub\artdatabanken\src\dialogs\fields\HorizontalInput.tsx", "TypeScript JSX", 0, 0, 34, 0, 0, 3, 37
"c:\GitHub\artdatabanken\src\dialogs\fields\Input.tsx", "TypeScript JSX", 0, 0, 26, 0, 0, 3, 29
"c:\GitHub\artdatabanken\src\dialogs\fields\Select.tsx", "TypeScript JSX", 0, 0, 29, 0, 0, 3, 32
"c:\GitHub\artdatabanken\src\dialogs\fields\fields.module.css", "CSS", 0, 6, 0, 0, 0, 1, 7
"c:\GitHub\artdatabanken\src\dialogs\fields\index.ts", "TypeScript", 4, 0, 0, 0, 0, 2, 6
"c:\GitHub\artdatabanken\src\dialogs\index.ts", "TypeScript", 5, 0, 0, 0, 0, 2, 7
"c:\GitHub\artdatabanken\src\index.css", "CSS", 0, 48, 0, 0, 4, 8, 60
"c:\GitHub\artdatabanken\src\lib\auth.ts", "TypeScript", 21, 0, 0, 0, 2, 6, 29
"c:\GitHub\artdatabanken\src\lib\compareFunction.ts", "TypeScript", 30, 0, 0, 0, 3, 10, 43
"c:\GitHub\artdatabanken\src\lib\firebase\checkIfFileExists.ts", "TypeScript", 22, 0, 0, 0, 0, 5, 27
"c:\GitHub\artdatabanken\src\lib\firebase\deleteCollection.ts", "TypeScript", 15, 0, 0, 0, 2, 5, 22
"c:\GitHub\artdatabanken\src\lib\firebase\deleteFile.ts", "TypeScript", 14, 0, 0, 0, 0, 3, 17
"c:\GitHub\artdatabanken\src\lib\firebase\firestore.ts", "TypeScript", 20, 0, 0, 0, 0, 5, 25
"c:\GitHub\artdatabanken\src\lib\firebase\getDownloadURLs.ts", "TypeScript", 12, 0, 0, 0, 2, 4, 18
"c:\GitHub\artdatabanken\src\lib\firebase\index.ts", "TypeScript", 31, 0, 0, 0, 2, 6, 39
"c:\GitHub\artdatabanken\src\lib\firebase\metadata.ts", "TypeScript", 1847, 0, 0, 0, 0, 1, 1848
"c:\GitHub\artdatabanken\src\lib\firebase\unused.ts", "TypeScript", 39, 0, 0, 0, 18, 11, 68
"c:\GitHub\artdatabanken\src\lib\firebase\uploadFile.ts", "TypeScript", 38, 0, 0, 0, 2, 4, 44
"c:\GitHub\artdatabanken\src\lib\index.ts", "TypeScript", 17, 0, 0, 0, 0, 6, 23
"c:\GitHub\artdatabanken\src\lib\options.tsx", "TypeScript JSX", 0, 0, 59, 0, 0, 10, 69
"c:\GitHub\artdatabanken\src\lib\saveToFile.ts", "TypeScript", 31, 0, 0, 0, 1, 3, 35
"c:\GitHub\artdatabanken\src\main.tsx", "TypeScript JSX", 0, 0, 10, 0, 0, 2, 12
"c:\GitHub\artdatabanken\src\pages\About.tsx", "TypeScript JSX", 0, 0, 11, 0, 0, 2, 13
"c:\GitHub\artdatabanken\src\pages\Collections\A4Page.tsx", "TypeScript JSX", 0, 0, 45, 0, 1, 10, 56
"c:\GitHub\artdatabanken\src\pages\Collections\Collections.module.css", "CSS", 0, 62, 0, 0, 1, 10, 73
"c:\GitHub\artdatabanken\src\pages\Collections\Collections.tsx", "TypeScript JSX", 0, 0, 44, 0, 0, 9, 53
"c:\GitHub\artdatabanken\src\pages\Home.module.css", "CSS", 0, 3, 0, 0, 0, 1, 4
"c:\GitHub\artdatabanken\src\pages\Home.tsx", "TypeScript JSX", 0, 0, 41, 0, 0, 4, 45
"c:\GitHub\artdatabanken\src\pages\ImageView\FilterAndSortForm.tsx", "TypeScript JSX", 0, 0, 37, 0, 0, 8, 45
"c:\GitHub\artdatabanken\src\pages\ImageView\ImageGrid.tsx", "TypeScript JSX", 0, 0, 25, 0, 0, 4, 29
"c:\GitHub\artdatabanken\src\pages\ImageView\ImageView.module.css", "CSS", 0, 22, 0, 0, 0, 5, 27
"c:\GitHub\artdatabanken\src\pages\ImageView\ImageView.tsx", "TypeScript JSX", 0, 0, 38, 0, 0, 7, 45
"c:\GitHub\artdatabanken\src\pages\Page.module.css", "CSS", 0, 11, 0, 0, 0, 3, 14
"c:\GitHub\artdatabanken\src\pages\Page.tsx", "TypeScript JSX", 0, 0, 35, 0, 0, 4, 39
"c:\GitHub\artdatabanken\src\pages\Settings\Settings.module.css", "CSS", 0, 16, 0, 0, 7, 4, 27
"c:\GitHub\artdatabanken\src\pages\Settings\Settings.tsx", "TypeScript JSX", 0, 0, 149, 0, 0, 14, 163
"c:\GitHub\artdatabanken\src\pages\Settings\createImageBundle.ts", "TypeScript", 38, 0, 0, 0, 0, 8, 46
"c:\GitHub\artdatabanken\src\pages\Settings\exportDatabase.ts", "TypeScript", 25, 0, 0, 0, 2, 7, 34
"c:\GitHub\artdatabanken\src\pages\Settings\importImages.ts", "TypeScript", 24, 0, 0, 0, 0, 5, 29
"c:\GitHub\artdatabanken\src\pages\Settings\importSpeciesBundle.ts", "TypeScript", 34, 0, 0, 0, 0, 7, 41
"c:\GitHub\artdatabanken\src\pages\Settings\mergeChangesIntoBundle.ts", "TypeScript", 13, 0, 0, 0, 4, 7, 24
"c:\GitHub\artdatabanken\src\pages\Settings\readUploadedFileAsText.ts", "TypeScript", 13, 0, 0, 0, 0, 3, 16
"c:\GitHub\artdatabanken\src\pages\SpeciesView\Filters.tsx", "TypeScript JSX", 0, 0, 83, 0, 2, 18, 103
"c:\GitHub\artdatabanken\src\pages\SpeciesView\SpeciesView.module.css", "CSS", 0, 7, 0, 0, 0, 2, 9
"c:\GitHub\artdatabanken\src\pages\SpeciesView\SpeciesView.tsx", "TypeScript JSX", 0, 0, 110, 0, 0, 14, 124
"c:\GitHub\artdatabanken\src\pages\index.ts", "TypeScript", 6, 0, 0, 0, 0, 2, 8
"c:\GitHub\artdatabanken\src\state\customStorage.ts", "TypeScript", 32, 0, 0, 0, 0, 4, 36
"c:\GitHub\artdatabanken\src\state\fetchGlobalState.ts", "TypeScript", 19, 0, 0, 0, 2, 7, 28
"c:\GitHub\artdatabanken\src\state\index.ts", "TypeScript", 69, 0, 0, 0, 8, 11, 88
"c:\GitHub\artdatabanken\src\vite-env.d.ts", "TypeScript", 26, 0, 0, 0, 1, 5, 32
"Total", "-", 2493, 240, 1460, 3, 78, 426, 4700